{
  "rows": [
    "TTTPTTTTTTTTTTTTTTTTTTTTTTTTTTTTTTTTTTTTTTTTTTTTTT",
    "PPPPTTTTTTTTTTTTTWWWWWWWWWTTTTTTTTTTTTWWWWWWWWWWTT",
    "PPPPTTTTTTTTTTTTTWWWWWWWWWTTTTTTTTTTTTWWWWWWWWWWTT",
    "PPPPTTTTTTTTTTTTTWWWWWWWWWTTTTTTTTTTTTWWWWWWWWWWTT",
    "PPPPTTTTTTTTTTTTTWWWWWWWWWTTTTTTTTTTTTWWWWWWWWWWTT",
    "PPPPTTTTTTTTTTTTTWWWWWWWWWTTTTTTTTTTTTWWWWWWWWWWTT",
    "PPPPTTTTTTTTTTTTTWWWWWWWWWTTTTTTTTTTTTWWWWWWWWWWTT",
    "PPPPTTTTTTTTTTTTTWWWWWWWWWTTTTTTTTTTTTWWWWWWWWWWPP",
    "PPPPTTTTTTTTTTTTTWWWWDWWWWTTTTTTTTTTTTWWWWDWWWWWPP",
    "PPPPPPPPPPPPPPPPPPPPPSPPPPPPPPPPPPPPPPPPPPSPPPPPPP",
    "PPPPWWWWWWWWTWWWWWWWPTTTTTTTTP~~~~~~TPTTTTTTTTTTTT",
    "PPPPWWWWWWWWTWWWWWWWPTTTTTTTTP~~~~~~TPTTTTTTTTTTTT",
    "PPPPWWWWWWWWTWWWWWWWPTTTTTTPPP~~P~~~TPTTTTTTTTTTTT",
    "PPPPWWWWDWWWSTTTTTTTPTTTTTTTPPPPPPPPPPTTTTTTTTTTTT",
    "PPPPPPPPPPPPPPPPPPPPPPPPPPPPPPPPPPPPPPPPPPPPPPPPPP",
    "TTTPTTTTTTTTTTTTTTTTPTTTTTTTTTTTTTTTTPTTTTTTTTTTTT",
    "TTTPTTTTTTTTTTTTTTTTPTPTTTWWWWWWWWWTWWWWWWWWWTTTTT",
    "TTTPTTTTPTTTTTTTTTTTPTTTTTWWWWWWWWWTWWWWWWWWWTTTTT",
    "TTTPTTTTTTTTTTTTTTTTPTTTTTWWWWWWWWWTWWWWWWWWWTTTTT",
    "TTTPTTTTTTTTTTPTTTTTPTTTTTWWWWWWWWWTWWWWWWWWWTTTTT",
    "TTTPTTTTTTTTTTTTTTTTPTTTTTWWWWWWWWWTWWWWWWWWWTTTTT",
    "PPPPPPPPPPPPPPPPPPPPPPPPPPPSPPPPPSPPPPPPPPPPPPPPPP",
    "TTTPTTTTTTTTTTTTTTTTPTTTTPTTTTTTTTTTTPTTTTTTTTTTTT",
    "TTTPTTTTTTTTTTTTTTTTPTTTTTTTTTTTTTTTTPTTTTTTTTTTTT",
    "TTTPTTTTTTTTWWWWWWWWWWTTTTTTTTTTTTTTTPTTTTTTTTTTTT",
    "TTTPTTTTTTTTWWWWWWWWWWTTTTTTTTTTTTTTTPTTTTTTTTTTTT",
    "TTTPTTTTTTTTWWWWWWWWWWTTTTTTTTTTTTTTTPTTTTTTTTTTTT",
    "TTTPTTTTTTTTWWWWWWWWWWTTTTTTTTTTTTTTTPTTTTTTTTTTTT",
    "TTTPTTTTTTTPWDWWWWWWWWTTTTTTTTTTTTTTTPTTTTTTTTTTTT",
    "PPPPPPPPPPPPPSPPPPPPPPPPPPPPPPPPPPPPPPPPPPPPPPPPPP",
    "PPPPPPPPPPPPPPPPPPPPPPPPPPPPPPPPPPPPPPPPPPPPPPPPPP",
    "PPPPPPPPPPPPPPPPPPPPPPPPPPPPPPPPPPPPPPPPPPPPPPPPPP",
    "PPPPPPPPPPPPPPPPPPPPPPPPPPPPPPPPPPPPPPPPPPPPPPPPPP",
    "PPPPPPPPPPPPPPPPPPPPPPPPPPPPPPPPPPPPPPPPPPPPPPPPPP",
    "PPPPPPPPPPPPPPPPPPPPPPPPPPPPPPPPPPPPPPPPPPPPPPPPPP",
    "TTTPTTTTTTTTTTTTTTTTPTTTTTTTTTTTTTTTTPTTTTTTTTTTTT"
  ],
  "warps": [
    {
      "x": 42,
      "y": 8,
      "targetMap": "POKECENTER",
      "targetPos": {
        "x": 6,
        "y": 7
      },
      "targetDir": "up"
    }
  ]
}