{
  "rows": [
    "TTTTTTTTTTTTTTTTTTTTTTTTTTTTTTTTTTTTTTTT",
    "TPPPPPPPPPPPPPPPPPPPPPPPPPPPPPPPPPPPPPPT",
    "TPPPPPPPPPPPPPPPPPPPPPPPPPPPPPPPPPPPPPPT",
    "TPPPPPPPPPPPPPPPPPPPPPPPPPPPPPPPPPPPPPPT",
    "TPPPPPPPPPPPPPPPPPPPPPPPPPPPPPPPPPPPPPPT",
    "TPPPPPPPPPPPPPPPPPPPPPPPPPPPPPPPPPPPPPPT",
    "TPPPPPPPPPPPPPPPPPPPPPPPPPPPPPPPPPPPPPPT",
    "TPPPPPPPPPPPPPPPPPPPPPPPPPPPPPPPPPPPPPPT",
    "TPPPPPPPPPPPPPPPPPPPPPPPPPPPPPPPPPPPPPPT",
    "TPPPPPPPPPPPPPPPPPPPPPPPPPPPPPPPPPPPPPPT",
    "TPPPPPPPPPPPPPPPPPPPPPPPPPPPPPPPPPPPPPPT",
    "TPPPPPPPPPPPPPPPPPPPPPPPPPPPPPPPPPPPPPPT",
    "TPPPPPPPPPPPPPPPPPPPPPPPPPPPPPPPPPPPPPPT",
    "TPPPPPPPPPPPPPPPPPPPPPPPPPPPPPPPPPPPPPPT",
    "TPPPPPWWWWPPPPPPPPPWWWWPPPPPPPPWWWWPPPPT",
    "TPPPPPWWWWPPPPPPPPPWWWWPPPPPPPPWWWWPPPPT",
    "TPPPPPWWWWPPPPPPPPPWWWWPPPPPPPPWWWWPPPPT",
    "TPPPPPPDPPPPPPPPPPPPDPPPPPPPPPPPDPPPPPPT",
    "GPPPPPPPPPPPPPPPPPPPPPPPPPPPPPPPPPPPPPPT",
    "TPPPPPPPPPPPPPPPPPPPPPPPPPPPPPPPPPPPPPPT",
    "TPPPPPPPPPPPPPPPPPPPPPPPPPPPPPPPPPPPPPPT",
    "TPPPPPPPPPPPPPPPPPPPPPPPPPPPPPPPPPPPPPPT",
    "TPPPPPPPPPPPPPPPPPPPPPPPPPPPPPPPPPPPPPPT",
    "TPPPPPPPPPPPPPPPPPPPPPPPPPPPPPPPPPPPPPPT",
    "TPPPPPPPPPPPPPPPPPPPPPPPPPPPPPPPPPPPPPPT",
    "TPPPPPPPPPPPPPPPPPPPPPPPPPPPPPPPPPPPPPPT",
    "TPPPPPPPPPPPPPPPPPPPPPPPPPPPPPPPPPPPPPPT",
    "TPPPPPPPPPPPPPPPPPPPPPPPPPPPPPPPPPPPPPPT",
    "TPPPPPPPPPPPPPPPPPPPPPPPPPPPPPPPPPPPPPPT",
    "TPPPPPPPPPPPPPPPPPPPPPPPPPPPPPPPPPPPPPPT",
    "TPPPPPPPPPPPPPPPPPPPPPPPPPPPPPPPPPPPPPPT",
    "TPPPPPPPPPPPPPPPPPPPPPPPPPPPPPPPPPPPPPPT",
    "TPPPPPPPPPPPPPPPPPPPPPPPPPPPPPPPPPPPPPPT",
    "TPPPPPPPPPPPPPPPPPPPPPPPPPPPPPPPPPPPPPPT",
    "TPPPPPPPPPPPPPPPPPPPPPPPPPPPPPPPPPPPPPPT",
    "TTTTTTTTTTTTTTTTTTTTTTTTTTTTTTTTTTTTTTTT"
  ],
  "warps": [
    { "x": 0, "y": 18, "targetMap": "ROUTE_4",       "targetPos": { "x": 39, "y": 4  }, "targetDir": "left" },
    { "x": 6, "y": 17, "targetMap": "CERULEAN_GYM",  "targetPos": { "x": 5,  "y": 13 }, "targetDir": "up" }
  ]
}
