{
  "rows": [
    "TTTTTTTTTTTTTTTTTTTTTTTTTTTTTTTTTTTTTTTT",
    "TPPPPPPPPPPPPPPPPPPPPPPPPPPPPPPPPPPPPPPT",
    "TPPPPPPPPPPPPPPPPPPPPPPPPPPPPPPPPPPPPPPT",
    "TPPPPPPPPPPPPPPPPPPPPPPPPPPPPPPPPPPPPPPT",
    "TPPPPPPPPPPPPPPPPPPPPPPPPPPPPPPPPPPPPPPT",
    "TPPPPPPPPPPPPPPPPPPPPPPPPPPPPPPPPPPPPPPT",
    "TPPPPPPPPPPPPPPPPPPPPPPPPPPPPPPPPPPPPPPT",
    "TPPPPPPPPPPPPPPPPPPPPPPPPPPPPPPPPPPPPPPT",
    "TPPPPPPPPPPPPPPPPPPPPPPPPPPWWWWPPPPPPPPT",
    "TPPPPPPPPPPPPPPPPPPPPPPPPPPWWWWPPPPPPPPT",
    "TPPPPPPPPPPPPPPPPPPPPPPPPPPWWWWPPPPPPPPT",
    "TPPPPPPPPPPPPPPPPPPPPPPPPPPPPDPPPPPPPPPT",
    "TPPPPPPPPPPPPPPPPPPPPPPPPPPPPPPPPPPPPPPT",
    "TPPPPPPPPPPPPPPPPPPPPPPPPPPPPPPPPPPPPPPT",
    "TPPPPPWWWWPPPPPPPPPWWWWPPPPPPPPWWWWPPPPT",
    "TPPPPPWWWWPPPPPPPPPWWWWPPPPPPPPWWWWPPPPT",
    "TPPPPPWWWWPPPPPPPPPWWWWPPPPPPPPWWWWPPPPT",
    "TPPPPPPDPPPPPPPPPPPPDPPPPPPPPPPPDPPPPPPT",
    "GPPPPPPPPPPPPPPPPPPPPPPPPPPPPPPPPPPPPPPT",
    "TPPPPPPPPPPPPPPPPPPPPPPPPPPPPPPPPPPPPPPT",
    "TPPPPPPPPPPPPPPPPPPPPPPPPPPPPPPPPPPPPPPT",
    "TPPPPPPPPPPPPPPPPPPPPPPPPPPPPPPPPPPPPPPT",
    "TPPPPPPPPPPPPPPPPPPPPPPPPPPPPPPPPPPPPPPT",
    "TPPPPPPPPPPPPPPPPPPPPPPPPPPPPPPPPPPPPPPT",
    "TPPPPPPPPPPPPPPPPPPPPPPPPPPPPPPPPPPPPPPT",
    "TPPPPPPPPPPPPPPPPPPPPPPPPPPPPPPPPPPPPPPT",
    "TPPPPPPPPPPPPPPPPPPPPPPPPPPPPPPPPPPPPPPT",
    "TPPPPPPPPPPPPPPPPPPPPPPPPPPPPPPPPPPPPPPT",
    "TPPPPPPPPPPPPPPPPPPPPPPPPPPPPPPPPPPPPPPT",
    "TPPPPPPPPPPPPPPPPPPPPPPPPPPPPPPPPPPPPPPT",
    "TPPPPPPPPPPPPPPPPPPPPPPPPPPPPPPPPPPPPPPT",
    "TPPPPPPPPPPPPPPPPPPPPPPPPPPPPPPPPPPPPPPT",
    "TPPPPPPPPPPPPPPPPPPPPPPPPPPPPPPPPPPPPPPT",
    "TPPPPPPPPPPPPPPPPPPPPPPPPPPPPPPPPPPPPPPT",
    "TPPPPPPPPPPPPPPPPPPPPPPPPPPPPPPPPPPPPPPT",
    "TTTTTTTTTTTTTTTTTTTTGTTTTTTTTTTTTTTTTTTT"
  ],
  "warps": [
    { "x": 0,  "y": 18, "targetMap": "ROUTE_4",      "targetPos": { "x": 39, "y": 4  }, "targetDir": "left" },
    { "x": 20, "y": 35, "targetMap": "ROUTE_5",      "targetPos": { "x": 4,  "y": 0  }, "targetDir": "down" },
    { "x": 29, "y": 11, "targetMap": "POKECENTER",   "targetPos": { "x": 6,  "y": 6  }, "targetDir": "up" },
    { "x": 7,  "y": 17, "targetMap": "CERULEAN_GYM", "targetPos": { "x": 5,  "y": 12 }, "targetDir": "up" },
    { "x": 20, "y": 17, "targetMap": "POKEMART",     "targetPos": { "x": 3,  "y": 6  }, "targetDir": "up" },
    { "x": 32, "y": 17, "targetMap": "POKECENTER",   "targetPos": { "x": 6,  "y": 6  }, "targetDir": "up" }
  ]
}
