{
  "rows": [
    "WWWWWWWWWWWWWWWWWWWW",
    "WCCCCCCCCCCCCCCCCCCW",
    "WCCCCCCCCCCCCCCCCCCW",
    "WCCCCCCCCCCCCCCCCCCW",
    "WCCCCCCCCCCCCCCCCCCW",
    "WCCCCCCCCCCCCCCCCCCW",
    "WCCCCCCCCCCCCCCCCCCW",
    "WCCCCCCCCCCCCCCCCCCW",
    "WCCCCCCCCCCCCCCCCCCW",
    "WCCCCCCCCCCCCCCCCCCW",
    "WWWWWWWWDWWWWWWWWWW"
  ],
  "warps": [
    { "x": 10, "y": 10, "targetMap": "INDIGO_PLATEAU_LOBBY", "targetPos": { "x": 10, "y": 1 }, "targetDir": "down" }
  ]
}
