{
  "rows": [
    "TTTTTTTTTTGTTTTTTTTT",
    "TPPPPPPPPPPPPPPPPPPT",
    "TPPPPPPPPPPPPPPPPPPT",
    "TPPPPPPPPPPPPPPPPPPT",
    "TPPWWWWPPPPPPWWWWPPT",
    "TPPWWWWPPPPPPWWWWPPT",
    "TPPWWWWPPPPPPWWWWPPT",
    "TPPPDPPPPPPPPPDPPPPT",
    "TPPPPPPPPPPPPPPPPPPT",
    "TPPPPPPWWWWWWPPPPPPT",
    "TPPPPPPWWWWWWPPPPPPT",
    "TPPPPPPWWWWWWPPPPPPT",
    "TPPPPPPWWWWWWPPPPPPT",
    "TPPPPPPPPPDPPPPPPPPT",
    "TPPPPPPPPPPPPPPPPPPT",
    "TPPPPPPPPPPPPPPPPPPT",
    "TPPPPPPPPPPPPPPPPPPT",
    "TTTTTTTTTTTTTTTTTTTT"
  ],
  "warps": [
    { "x": 10, "y": 0,  "targetMap": "ROUTE_10",         "targetPos": { "x": 4, "y": 22 }, "targetDir": "up" },
    { "x": 9,  "y": 13, "targetMap": "POKEMON_TOWER_1F", "targetPos": { "x": 10, "y": 16 }, "targetDir": "up" }
  ]
}
