{
  "rows": [
    "GGGGGGGGGGGGGGGGGGGG",
    "GGGGGGGGGGGGGGGGGGGG",
    "GPPPPPPPPPPPPPPPPPPG",
    "GPPPPGGGGGGGGGGGGPPG",
    "GPPGGGGGGGGGGGGGGPPG",
    "GPPGGGGGGGGGGGGGGPPG",
    "GPPGGBGGGGGGBGGGGPPG",
    "GPPGGGGBGGGGGGGGGPPG",
    "GPPGGGGGGGGGBGGGGPPG",
    "GPPGGBGGGGGGGGGGGPPG",
    "GPPGGGGGGGBGGGGGGPPG",
    "GPPGGGBGGGGGGGBGGPPG",
    "GPPGGGGGGGGGGGGGGPPG",
    "GPPGGGGGGGGGGGGGGPPG",
    "GPPGGGGGGGGGGGGGGPPG",
    "GPPGGGGGGGGGGGGGGPPG",
    "GPPGGGGGGGGGGGGGGPPG",
    "GPPGGGGGGGGGGGGGGPPG",
    "GGGGGGGGGGGGGGGGGGGG",
    "GGGGGGGGGGGGGGGGGGGG"
  ],
  "warps": [
    { "x": 15, "y": 15, "targetMap": "MT_MOON_B1F", "targetPos": { "x": 15, "y": 15 }, "targetDir": "up" }
  ]
}
