{
  "rows": [
    "BBBBBBBBBBBBBBBBBBBB",
    "BBBBBBBBBBBBBBBBBBBB",
    "BPPPPPPPPPPPPPPPPPPB",
    "BPPPPBBBBBBBBBBBBPPB",
    "BPPBBBBBBBBBBBBBBPPB",
    "BPPBBBBBBBBBBBBBBPPB",
    "BPPBBBBBBBBBBBBBBPPB",
    "BPPBBBBBBBBBBBBBBPPB",
    "BPPBBBBBBBBBBBBBBPPB",
    "BPPBBBBBBBBBBBBBBPPB",
    "BPPBBBBBBBBBBBBBBPPB",
    "BPPBBBBBBBBBBBBBBPPB",
    "BPPBBBBBBBBBBBBBBPPB",
    "BPPBBBBBBBBBBBBBBPPB",
    "BPPBBBBBBBBBBBBBBPPB",
    "BPPBBBBBBBBBBBBBBPPB",
    "BPPBBBBBBBBBBBBBBPPB",
    "BPPBBBBBBBBBBBBBBPPB",
    "BBBBBBBBBBBBBBBBBBBB",
    "BBBBBBBBBBBBBBBBBBBB"
  ],
  "warps": [
    { "x": 10, "y": 18, "targetMap": "ROUTE_3", "targetPos": { "x": 10, "y": 1 }, "targetDir": "down" }
  ]
}