{
  "rows": [
    "GGGGGGGGGGGGGGGGGGGG",
    "GGGGGGGGGGGGGGGGGGGG",
    "GPPPPPPPPPPPPPPPPPPG",
    "GPPPPGGGGGGGGGGGGPPG",
    "GPPGGGGGGGGGGGGGGPPG",
    "GPPGGGGGGGGGGGGGGPPG",
    "GPPGGGGGGGGGGGGGGPPG",
    "GPPGGGGGGGGGGGGGGPPG",
    "GPPGGGGGGGGGGGGGGPPG",
    "GPPGGGGGGGGGGGGGGPPG",
    "GPPGGGGGGGGGGGGGGPPG",
    "GPPGGGGGGGGGGGGGGPPG",
    "GPPGGGBGGGGBGGGGGPPG",
    "GPPGGGGBGGGGGGGGGPPG",
    "GPPGGGGGGGGBGGBGGPPG",
    "GPPGGBGGGGGGGGGGGPPG",
    "GPPGGGGGGGBGGGBGGPPG",
    "GPPGGGGGGGGGGGGGGPPG",
    "GGGGGGGGGGGGGGGGGGGG",
    "GGGGGGGGGGGGGGGGGGGG"
  ],
  "warps": [
    { "x": 5,  "y": 4,  "targetMap": "MT_MOON",      "targetPos": { "x": 5,  "y": 4  }, "targetDir": "up" },
    { "x": 15, "y": 15, "targetMap": "MT_MOON_B2F",  "targetPos": { "x": 15, "y": 15 }, "targetDir": "down" }
  ]
}
