{
  "rows": [
    "GGGGGGGGGGGGGGGGGGGG",
    "GGGGGGGGGGGGGGGGGGGG",
    "GPPPPPPPPPPPPPPPPPPG",
    "GPPPPGGGGGGGGGGGGPPG",
    "GPPGGGGGGGGGGGGGGPPG",
    "GPPGGGGGGGGGGGGGGPPG",
    "GPPGGGBGGGGGGGGBGPPG",
    "GPPGGGGGGGGBGGGGGPPG",
    "GPPGGBGGGGGGGGGGGPPG",
    "GPPGGGGGGGGBGGGGGPPG",
    "GPPGGGGBGGGGGGGBGPPG",
    "GPPGGGGGGGGGGGGGGPPG",
    "GPPGGGGBGGGGGGGGGPPG",
    "GPPGGGGGGGGGGGGGGPPG",
    "GPPGGGGGGGGGGGGGGPPG",
    "GPPGGGGGGGGGGGGGGPPG",
    "GPPGGGGGGGGGGGGGGPPG",
    "GPPGGGGGGGGGGGGGGPPG",
    "GGGGGGGGGGGGGGGGGGGG",
    "GGGGGGGGGGGGGGGGGGGG"
  ],
  "warps": [
    {
      "x": 5,
      "y": 4,
      "targetMap": "MT_MOON_B1F",
      "targetPos": { "x": 5, "y": 4 },
      "targetDir": "down"
    }
  ]
}
