{
  "rows": [
    "WWWWWWWWWWWWWWWWWWWW",
    "WWWWWWWWWWWWWWWWWWWW",
    "WWPPPPPPPPPPPPPPPPWW",
    "WWPPPPPPPPPPPPPPPPWW",
    "WWPPWWWWPPPPWWWWPPWW",
    "WWPPWWWWPPPPWWWWPPWW",
    "WWPPWWWWPPPPWWWWPPWW",
    "WWPPWWDWPPPPWWDWPPWW",
    "WWPPPPPPPPPPPPPPPPWW",
    "WWPPPPPPPPPPPPPPPPWW",
    "WWPPPPPPWWWWWPPPPPWW",
    "WWPPPPPPWWWWWPPPPPWW",
    "WWPPPPPPWWWWWPPPPPWW",
    "WWPPPPPPWWDWWPPPPPWW",
    "WWPPPPPPPPPPPPPPPPWW",
    "WWPPPPPPPPPPPPPPPPWW",
    "WWPPPPPPPPPPPPPPPPWW",
    "WWPPPPPPPPPPPPPPPPWW",
    "WWWWWWWWWWWWWWWWWWWW",
    "WWWWWWWWWWWWWWWWWWWW"
  ]
}
