{
  "rows": [
    "PPPPPPPPPPPPPPPPPPPPPPPPPPPPPP",
    "PPPPPPPPPPPPPPPPPPPPPPPPPPPPPP",
    "PPPPPPPPPPPPPPPPPPPPPPPPPPPPPP",
    "PPPPPPPPPPPPPPPPPPPPPPPPPPPPPP",
    "PPPPPPPPPPPPPPPPPPPPPPPPPPPPPP",
    "PPPPWWWWPPPPPPPPPPWWWWPPPPPPPP",
    "PPPPWWWWPPPPPPPPPPWWWWPPPPPPPP",
    "PPPPWWWWPPPPPPPPPPWWWWPPPPPPPP",
    "PPPPPDPPPPPPPPPPPPPDPPPPPPPPPP",
    "PPPPPPPPPPPPPPPPPPPPPPPPPPPPPP",
    "PPPPPPPPPPPPPPPPPPPPPPPPPPPPPP",
    "PPPPPPPPPPWWWWWWWPPPPPPPPPPPPP",
    "PPPPPPPPPPWWWWWWWPPPPPPPPPPPPP",
    "PPPPPPPPPPWWWWWWWPPPPPPPPPPPPP",
    "PPPPPPPPPPPDPPPPPPPPPPPPPPPPPP",
    "PPPPPPPPPPPPPPPPPPPPPPPPPPPPPP",
    "PPPPPPPPPPPPPPPPPPPPPPPPPPPPPP",
    "PPPPPPPPPPPPPPPPPPPPPPPPPPPPPP",
    "PPPPPPPPPPPPPPPPPPPPPPPPPPPPPP",
    "PPPPPPPPPPPPPPPPPPPPPPPPPPPPPP",
    "PPPPPPPPPPPPPPPPPPPPPPPPPPPPPP",
    "PPPPPPPPPPPPPPPPPPPPPPPPPPPPPP",
    "PPPPPPPPPPPPPPPPPPPPPPPPPPPPPP",
    "PPPPPPPPPPPPPPPPPPPPPPPPPPPPPP",
    "PPPPPPPPPPPPPPPPPPPPPPPPPPPPPP",
    "PPPPPPPPPPPPPPPPPPPPPPPPPPPPPP",
    "PPPPPPPPPPPPPPPGPPPPPPPPPPPPPP"
  ],
  "warps": [
    { "x": 15, "y": 26, "targetMap": "VIRIDIAN_FOREST", "targetPos": { "x": 11, "y": 0  }, "targetDir": "down" },
    { "x": 11, "y": 14, "targetMap": "PEWTER_GYM",      "targetPos": { "x": 3,  "y": 13 }, "targetDir": "up" },
    { "x": 29, "y": 14, "targetMap": "ROUTE_3",         "targetPos": { "x": 0,  "y": 8  }, "targetDir": "right" }
  ]
}
