{
  "rows": [
    "TTTTTTTTTTTTTTTTTTTTTTTTTTTTTTTTTTTTTTTT",
    "TPPPPPPPPPPPPPPPPPPPPPPPPPPPPPPPPPPPPPPT",
    "TPPPPPPPPPPPPPPPPPPPPPPPPPPPPPPPPPPPPPPT",
    "TPPPPPPPPPPPPPPPPPPPPPPPPPPPPPPPPPPPPPPT",
    "TPPPPPPPPPPPPPPPPPPPPPPPPPPPPPPPPPPPPPPT",
    "TPPPPPPPPPPPPPPPPPPPPPPPPPPPPPPPPPPPPPPT",
    "TPPPPWWWWWPPPPPPPPPPPPPPPPPPPPPPPPPPPPPT",
    "TPPPPWWWWWPPPPPPPPPPPPPPPPPPPPPPPPPPPPPT",
    "TPPPPWWWWWPPPPPPPPPPPPPPPPPPPPPPPPPPPPPT",
    "TPPPPPPDPPPPPPPPPPPPPPPPPPPPPPPPPPPPPPPT",
    "TPPPPPPPPWWWWPPPPPPPPPPWWWWPPPPPPPPPPPPT",
    "TPPPPPPPPWWWWPPPPPPPPPPWWWWPPPPPPPPPPPPT",
    "TPPPPPPPPWWWWPPPPPPPPPPWWWWPPPPPPPPPPPPT",
    "TPPPPPPPPPDPPPPPPPPPPPPPDPPPPPPPPPPPPPPT",
    "TPPPPPPPPPPPPPPPPPPPPPPPPPPPPPPPPPPPPPPT",
    "TPPPPPPPPPPPPPPPPPPPPPPPPPPPPPPPPPPPPPPT",
    "TPPPPPPPPPPPPPPWWWWWWWPPPPPPPPPPPPPPPPPT",
    "TPPPPPPPPPPPPPPWWWWWWWPPPPPPPPPPPPPPPPPT",
    "TPPPPPPPPPPPPPPWWWWWWWPPPPPPPPPPPPPPPPPT",
    "TPPPPPPPPPPPPPPPDPPPPPPPPPPPPPPPPPPPPPPP",
    "TPPPPPPPPPPPPPPPPPPPPPPPPPPPPPPPPPPPPPPT",
    "TPPPPPPPPPPPPPPPPPPPPPPPPPPPPPPPPPPPPPPT",
    "TPPPPPPPPPPPPPPPPPPPPPPPPPPPPPPPPPPPPPPT",
    "TPPPPPPPPPPPPPPPPPPPPPPPPPPPPPPPPPPPPPPT",
    "TPPPPPPPPPPPPPPPPPPPPPPPPPPPPPPPPPPPPPPT",
    "TPPPPPPPPPPPPPPPPPPPPPPPPPPPPPPPPPPPPPPT",
    "TPPPPPPPPPPPPPPPPPPPPPPPPPPPPPPPPPPPPPPT",
    "TPPPPPPPPPPPPPPPPPPPPPPPPPPPPPPPPPPPPPPT",
    "TPPPPPPPPPPPPPPPPPPPPPPPPPPPPPPPPPPPPPPT",
    "TPPPPPPPPPPPPPPPPPPPPPPPPPPPPPPPPPPPPPPT",
    "TPPPPPPPPPPPPPPPPPPPPPPPPPPPPPPPPPPPPPPT",
    "TPPPPPPPPPPPPPPPPPPPPPPPPPPPPPPPPPPPPPPT",
    "TPPPPPPPPPPPPPPPPPPPPPPPPPPPPPPPPPPPPPPT",
    "TPPPPPPPPPPPPPPPPPPPPPPPPPPPPPPPPPPPPPPT",
    "TPPPPPPPPPPPPPPPPPPPPPPPPPPPPPPPPPPPPPPT",
    "TTTTTTTTTTTTTTTTTTTTGTTTTTTTTTTTTTTTTTTT"
  ],
  "warps": [
    {
      "x": 20,
      "y": 35,
      "targetMap": "KANTO_OVERWORLD",
      "targetPos": {
        "x": 20,
        "y": 42
      },
      "targetDir": "down"
    },
    {
      "x": 16,
      "y": 19,
      "targetMap": "PEWTER_GYM",
      "targetPos": {
        "x": 3,
        "y": 13
      },
      "targetDir": "up"
    },
    {
      "x": 39,
      "y": 19,
      "targetMap": "KANTO_OVERWORLD",
      "targetPos": {
        "x": 39,
        "y": 26
      },
      "targetDir": "right"
    }
  ]
}