{
  "rows": [
    "WWWWWWWWWWWWWWWWWWWW",
    "WWWWWWWWWWWWWWWWWWWW",
    "WWWWWWWWWWWWWWWWWWWW",
    "WWWWWWWWWWWWWWWWWWWW",
    "WWWWWWWWWWWWWWWWWWWW",
    "WWWWWFFFFFFFFFFFWWWW",
    "WWWWWFFFFFFFFFFFWWWW",
    "WWWWWFFFFFFFFFFFWWWW",
    "WWWWWFFFFFFFFFFFWWWW",
    "WWWWWFFFFFFFFFFFWWWW",
    "WWWWWFFFFFFFFFFFWWWW",
    "WWWWWFFFFFFFFFFFWWWW",
    "WWWWWFFFFFFFFFFFWWWW",
    "WWWWWFFFFFFFFFFFWWWW",
    "WWWWWFFFFFFFFFFFWWWW",
    "WWWWWFFFFFCFFFFFWWWW",
    "WWWWWWWWWWWWWWWWWWWW",
    "WWWWWWWWWWWWWWWWWWWW",
    "WWWWWWWWWWWWWWWWWWWW",
    "WWWWWWWWWWWWWWWWWWWW"
  ]
}
