{
  "rows": [
    "WWWWWWWWWWWWWWWWWWWW",
    "WWWWWWWWWWWWWWWWWWWW",
    "WWWWWWWWWWWWWWWWWWWW",
    "WWWWWWWWWWWWWWWWWWWW",
    "WWWWWWWWWWWWWWWWWWWW",
    "WWWWWXXXFFFFFFFFWWWW",
    "WWWWWFFFFFFFFFFFWWWW",
    "WWWWWFFFFFFFFFFFWWWW",
    "WWWWWFFFFFFFFFFFWWWW",
    "WWWWWFFFFFFFFFFFWWWW",
    "WWWWWFFFFFFFFFFFWWWW",
    "WWWWWFFFFFFFFFFFWWWW",
    "WWWWWFFFFFFFFFFFWWWW",
    "WWWWWFFFFFFFFFFFWWWW",
    "WWWWWFFFFFCFFFFFWWWW",
    "WWWWWWWWWWDWWWWWWWWW",
    "WWWWWWWWWWWWWWWWWWWW",
    "WWWWWWWWWWWWWWWWWWWW",
    "WWWWWWWWWWWWWWWWWWWW",
    "WWWWWWWWWWWWWWWWWWWW"
  ],
  "warps": [
    { "x": 10, "y": 15, "targetMap": "PLAYERS_HOUSE_1F", "targetPos": { "x": 5, "y": 6 }, "targetDir": "down" }
  ]
}
