{
  "rows": [
    "WWWWWWWWWWWWWWWWWWWW",
    "WFFFFFFFFFFFFFFFFFFW",
    "WFFFFFFFFFFFFFFFFFFW",
    "WFFFFFFFFFFFFFFFFFFW",
    "WFFFFFFFFFFFFFFFFFFW",
    "WFFFFFFFFFFFFFFFFFFW",
    "WFFFFFFFFFFFFFFFFFFW",
    "WFFKFFFFFFFFFFFFKFFW",
    "WFFKFFFFFFFFFFFFKFFW",
    "WFFFFFFFFFFFFFFFFFFW",
    "WFFFFFFFFFFFFFFFFFFW",
    "WFFFFFFFFFFFFFFFFFFW",
    "WFFFFFFFFFFFFFFFFFFW",
    "WFFFFFFFFFFFFFFFFFFW",
    "WFFFFFFFFFFFFFFFFFFW",
    "WFFFFFFFFFFFFFFFFFFW",
    "WFFFFFFFFFDFFFFFFFFW",
    "WWWWWWWWWWWWWWWWWWWW"
  ],
  "warps": [
    { "x": 10, "y": 16, "targetMap": "LAVENDER_TOWN", "targetPos": { "x": 9, "y": 14 }, "targetDir": "down" }
  ]
}
