{
  "rows": [
    "WWWWWWWWWWWWWWWWWWWW",
    "WGGGGGGGGGGGGGGGGGGW",
    "WGGGGGGGGGGGGGGGGGGW",
    "WGGGGGGGGGGGGGGGGGGW",
    "WGGGGGGGGGGGGGGGGGGW",
    "WGGGGGGGGGGGGGGGGGGW",
    "WGGGGGGGGGGGGGGGGGGW",
    "WGGGGGGGGGGGGGGGGGGW",
    "WGGGGGGGGGGGGGGGGGGW",
    "WGGGGGGGGGGGGGGGGGGW",
    "WGGGGGGGGGGGGGGGGGGW",
    "WGGGGGGGGGGGGGGGGGGW",
    "WGGGGGGGGGGGGGGGGGGW",
    "WGGGGGGGGGGGGGGGGGGW",
    "WGGGGGGGGGGGGGGGGGGW",
    "WGGGGGGGGGGGGGGGGGGW",
    "WGGGGGGGGGGGGGGGGGGW",
    "WWWWWWWWWWWWWWWWWWWW"
  ],
  "warps": [
    {
      "x": 3,
      "y": 1,
      "targetMap": "POKEMON_TOWER_2F",
      "targetPos": {
        "x": 3,
        "y": 1
      },
      "targetDir": "up"
    }
  ]
}
