{
  "rows": [
    "WWWWWWWWWWWWWWWWWWWW",
    "WGGGGGGGGGGGGGGGGGGW",
    "WGGGGGGGGGGGGGGGGGGW",
    "WGGGGGGGGGGGGGGGGGGW",
    "WGGGGGGGGGGGGGGGGGGW",
    "WGGGGGGGGGGGGGGGGGGW",
    "WGGGGGGGGGGGGGGGGGGW",
    "WGGGGGGGGGGGGGGGGGGW",
    "WGGGGGGGGGGGGGGGGGGW",
    "WGGGGGGGGGGGGGGGGGGW",
    "WGGGGGGGGGGGGGGGGGGW",
    "WGGGGGGGGGGGGGGGGGGW",
    "WGGGGGGGGGGGGGGGGGGW",
    "WGGGGGGGGGGGGGGGGGGW",
    "WGGGGGGGGGGGGGGGGGGW",
    "WGGGGGGGGGGGGGGGGGGW",
    "WGGGGGGGGGGGGGGGGGGW",
    "WWWWWWWWWWWWWWWWWWWW"
  ],
  "warps": [
    {
      "x": 18,
      "y": 1,
      "targetMap": "POKEMON_TOWER_2F",
      "targetPos": {
        "x": 18,
        "y": 1
      },
      "targetDir": "up"
    }
  ]
}
