{
  "rows": [
    "GGGGGGGGGGGGGGGGGGGG",
    "GGGGGGGGGGGGGGGGGGGG",
    "GGGGGGGGGGGGGGGGGGGG",
    "GGGGPGGGGGGGGGGGGGGG",
    "GGGGPGGGBGGGGGGGGGGG",
    "GGGGPGGGGGGGBGGGGGGG",
    "GGGGPGGGGGGGGGGBGGGG",
    "GGGGPGGBGGGGGGGGGGGG",
    "GGGGPPPPPPPPPPPPGGGG",
    "GGGGGGGGGGGGGGGPGGGG",
    "GGGBGGGGGGGGGGGPGGGG",
    "GGGGGGGGGGGBGGGPGGGG",
    "GGGGGGGGGGGGGGGPGGGG",
    "GGGGGGGGGGGBGGGPGGGG",
    "GGGGGGGGGGGGGGGPGGGG",
    "GGGGGGGGGGGGGGGGGGGG",
    "GGGGGGGGGGGGGGGGGGGG",
    "GGGGGGGGGGGGGGGGGGGG"
  ],
  "warps": [
    {
      "x": 15,
      "y": 5,
      "targetMap": "ROCK_TUNNEL_B1F",
      "targetPos": { "x": 15, "y": 5 },
      "targetDir": "down"
    }
  ]
}
