{
  "rows": [
    "WWWWWWWWWWWWWWWWWWWW",
    "WCCCCCCCCCCCCCCCCCCW",
    "WCCCCCCCCCCCCCCCCCCW",
    "WCCCCCCCCCCCCCCCCCCW",
    "WCCCCCCCCCCCCCCCCCCW",
    "WCCCCCCCCCCCCCCCCCCW",
    "WCCCCCCCCCCCCCCCCCCW",
    "WCCCCCCCCCCCCCCCCCCW",
    "WCCCCCCCCCCCCCCCCCCW",
    "WCCCCCCCCCCCCCCCCCCW",
    "WCCCCCCCCCCCCCCCCCCW",
    "WCCCCCCCCCCCCCCCCCCW",
    "WCCCCCCCCCCCCCCCCCCW",
    "WCCCCCCCCCCCCCCCCCCW",
    "WCCCCCCCCCCCCCCCCCCW",
    "WCCCCCCCCCCCCCCCCCCW",
    "WFFFFFFMMFFFFFFFFFW",
    "WFFFFFFFFFFFFFFFFFFW",
    "WWWWWWWWWWWWWWWWWWWW"
  ],
  "warps": [
    { "x": 1, "y": 17, "targetMap": "ROCKET_HIDEOUT_B3F", "targetPos": { "x": 1, "y": 1 }, "targetDir": "down" }
  ]
}
