{
  "rows": [
    "WWWWWWWWWWWWWWWWWWWW",
    "WFFFFFFFFFFFFFFFFFFW",
    "WFFFFFFFFFFFFFFFFFFW",
    "WFFFFFFFFFFFFFFFFFFW",
    "WFFFFFFFFFFFFFFFFFFW",
    "WFFFFFFFFFFFFFFFFFFW",
    "WFFFFFFFFFFFFFFFFFFW",
    "WFFFFFFFFFFFFFFFFFFW",
    "WFFFFFFFFFFFFFFFFFFW",
    "WFFFFFFFFFFFFFFFFFFW",
    "WFFFFFFFFFFFFFFFFFFW",
    "WFFFFFFFFFFFFFFFFFFW",
    "WFFFFFFFFFFFFFFFFFFW",
    "WFFFFFFFFFFFFFFFFFFW",
    "WFFFFFFFFFFFFFFFFFFW",
    "WFFFFFFFFFFFFFFFFFFW",
    "WFFFFFFFFFFFFFFFFFFW",
    "WFFFFFFFFFFFFFFFFFFW",
    "WFFFFFFFFFFFFFFFFFFW",
    "WWWWWWWWDWWWWWWWWWW"
  ],
  "warps": [
    { "x": 9, "y": 19, "targetMap": "KANTO_OVERWORLD", "targetPos": { "x": 173, "y": 93 }, "targetDir": "down" },
    { "x": 1, "y": 1, "targetMap": "ROCKET_HIDEOUT_B2F", "targetPos": { "x": 1, "y": 17 }, "targetDir": "up" }
  ]
}
