{
  "rows": [
    "WWWWWWWWWWWWWWWWWWWW",
    "WFFFFFFFFFFFFFFFFFFW",
    "WFFFFFWWWWWWWWFFFFFW",
    "WFFFFFWWFFFFWWFFFFFW",
    "WFFFFFWWFFFFWWFFFFFW",
    "WFFFFFWWFFFFWWFFFFFW",
    "WFFFFFWWFFFFWWFFFFFW",
    "WFFFFFFFFFFFFFFFFFFW",
    "WFFFFFWWFFFFWWFFFFFW",
    "WFFFFFWWFFFFWWFFFFFW",
    "WFFFFFWWFFFFWWFFFFFW",
    "WFFFFFWWFFFFWWFFFFFW",
    "WFFFFFFFFFFFFFFFFFFW",
    "WFFFFFWWWWWWWWFFFFFW",
    "WFFFFFWWFFFFWWFFFFFW",
    "WFFFFFWWFFFFWWFFFFFW",
    "WFFFFFFFFFFFFFFFFFFW",
    "WFFFFFFMMFFFFFFFFFW",
    "WFFFFFFFFFFFFFFFFFFW",
    "WWWWWWWWWWWWWWWWWWWW"
  ],
  "warps": [
    { "x": 1, "y": 17, "targetMap": "ROCKET_HIDEOUT_B1F", "targetPos": { "x": 1, "y": 1 }, "targetDir": "down" },
    { "x": 1, "y": 1, "targetMap": "ROCKET_HIDEOUT_B3F", "targetPos": { "x": 1, "y": 17 }, "targetDir": "up" }
  ]
}
