{
  "rows": [
    "TTTTTTTTTTTTTTTTTTTTTTTTTTTTTTGTTTTTTTTT",
    "TGGGGGGGGGGGGGGGGGGGGGGGGGGGGPGGGGGGGGGT",
    "TGGGGGGGGGGGGGGGGGGGGGGGGGGGGPGGGGGGGGGT",
    "TGGGGGGGGGGGGGGGGGGGGGGGGGGGGPGGGGGGGGGT",
    "TGGGGGGGGGGGGGGGGGGGGGGGGGGGGPGGGGGGGGGT",
    "TGGGGGGGGGGGGGGGGGGGGGGGGGGGGPGGGGGGGGGT",
    "TGGGGGGGGGGGGGGGGGGGGGGGGGGGGPGGGGGGGGGT",
    "TPPPPPPPPPPPPPPPPPPPPPPPPPPPPPPPPPPPPPPT",
    "PPPPPPPPPPPPPPPPPPPPPPPPPPPPPPPPPPPPPPPP",
    "TPPPPPPPPPPPPPPPPPPPPPPPPPPPPPPPPPPPPPPT",
    "TGGGGGGGGGGGGGGGGGGGGGGGGGGGGGGGGGGGGGGT",
    "TGGGGGGGGGGGGGGGGGGGGGGGGGGGGGGGGGGGGGGT",
    "TGGGGGGGGGGGGGGGGGGGGGGGGGGGGGGGGGGGGGGT",
    "TGGGGGGGGGGGGGGGGGGGGGGGGGGGGGGGGGGGGGGT",
    "TGGGGGGGGGGGGGGGGGGGGGGGGGGGGGGGGGGGGGGT",
    "TGGGGGGGGGGGGGGGGGGGGGGGGGGGGGGGGGGGGGGT",
    "TTTTTTTTTTTTTTTTTTTTTTTTTTTTTTTTTTTTTTTT",
    "TTTTTTTTTTTTTTTTTTTTTTTTTTTTTTTTTTTTTTTT"
  ],
  "warps": [
    { "x": 0,  "y": 8, "targetMap": "PEWTER_CITY", "targetPos": { "x": 39, "y": 19 }, "targetDir": "left"  },
    { "x": 30, "y": 0, "targetMap": "MT_MOON",     "targetPos": { "x": 10, "y": 19 }, "targetDir": "up" }
  ]
}
