{
  "rows": [
    "TTTTTTTTTTTTTTTTTTTTTTTTTTTTTTTTTTTTTTTT",
    "TGGGGGGGGGGGGGGGGGGGGGGGGGGGGGGGGGGGGGGT",
    "TGGGGGGGGGGGGGGGGGGGGGGGGGGGGGGGGGGGGGGT",
    "TGGGGGGGGGGGGGGGGGGGGGGGGGGGGGGGGGGGGGGT",
    "PPPPPPPPPPPPPPPPPPPPPPPPPPPPPPPPPPPPPPPP",
    "TPPPPPPLLLLLPPPPPPPPPPPPPPLLLLLPPPPPPPPT",
    "TGGGGGGGGGGGGGGGGGGGGGGGGGGGGGGGGGGGGGGT",
    "TGGGGGGGGGGGGGGGGGGGGGGGGGGGGGGGGGGGGGGT",
    "TGGGGGGGGGGGGGGGGGGGGGGGGGGGGGGGGGGGGGGT",
    "TTTTTTTTTTTTTTTTTTTTTTTTTTTTTTTTTTTTTTTT"
  ],
  "warps": [
    {
      "x": 39,
      "y": 4,
      "targetMap": "KANTO_OVERWORLD",
      "targetPos": {
        "x": 108,
        "y": 18
      },
      "targetDir": "right"
    }
  ]
}