{
  "rows": [
    "TTTTTTTTTTTTTTTTTTTT",
    "TTTTTTTTTTTTTTTTTTTT",
    "PGGGGGGPTTTTPGGGGGPP",
    "PGGGGGGPTTTTPGGGGGPP",
    "PPPPPPPTTTTTPPPPPPPP",
    "PPPPPPPTTTTTPPPPPPPP",
    "PGGGGPPTTTTTPGGGGGPP",
    "PGGGGPPTTTTTPGGGGGPP",
    "PGGGPPPPPPPPPPPGGGPP",
    "PPPPPPPPPPTTTTPPPPPP",
    "PPPPPPPPPPTTTTPPPPPP",
    "PGGGGGPPPPTTTTPGGGPP",
    "PGGGGGPPPPPPPPPGGGPP",
    "PPPPPPPTTTTPPPPPPPPP",
    "PGGGGPPTTTTPPGGGGPPP",
    "PGGGGPPTTTTPPGGGGPPP",
    "PPPPPPPPPPPPPPPGGGPP",
    "PPPPPPPPPPPPPPPGGGPP",
    "TTTTTTTTTTTTTTTTTTTT",
    "TTTTTTTTTTTTTTTTTTTT"
  ]
}
