{
  "rows": [
    "TTTTTTTTTTPTTTTTTTTT",
    "TTTTTTTTTTPTTTTTTTTT",
    "PGGGGGGPGGGGPGGGGGPP",
    "PGGGGGGPGGGGPGGGGGPP",
    "PPPPPPPGGGGTPPPPPPPP",
    "PPPPPPPGGGGTPPPPPPPP",
    "PGGGGPPGGGGTPGGGGGPP",
    "PGGGGPPGGGGTPGGGGGPP",
    "PGGGPPPPPPPPPPPGGGPP",
    "PPPPPPPPPPPPPPPPPPPP",
    "PPPPPPPPPPPPPPPPPPPP",
    "PGGGGGPPPPPPPPPGGGPP",
    "PGGGGGPPPPPPPPPGGGPP",
    "PPPPPPPPPPPPPPPPPPPP",
    "PGGGGPPPPPPPPGGGGPPP",
    "PGGGGPPPPPPPPGGGGPPP",
    "PPPPPPPPPPPPPPPGGGPP",
    "PPPPPPPPPPPPPPPGGGPP",
    "PPTTTTTTTTTTTTTTTTTT",
    "TTTTTTTTTTTTTTTTTTTT"
  ],
  "warps": [
    { "x": 0, "y": 8, "targetMap": "PEWTER_CITY", "targetPos": { "x": 16, "y": 8 }, "targetDir": "left" },
    { "x": 10, "y": 0, "targetMap": "MT_MOON", "targetPos": { "x": 10, "y": 17 }, "targetDir": "up" }
  ]
}