{
  "rows": [
    "TTTTTTTTTTTTTTTTTTTTTTTTTTTTTTGTTTTTTTTT",
    "TGGGGGGGGGGGGGGGGGGGGGGGGGGGGPGGGGGGGGGT",
    "TGGGGGGGGGGGGGGGGGGGGGGGGGGGGPGGGGGGGGGT",
    "TGGGGGGGGGGGGGGGGGGGGGGGGGGGGPGGGGGGGGGT",
    "TGGGGGGGGGGGGGGGGGGGGGGGGGGGGPGGGGGGGGGT",
    "TGGGGGGGGGGGGGGGGGGGGGGGGGGGGPGGGGGGGGGT",
    "TGGGGGGGGGGGGGGGGGGGGGGGGGGGGPGGGGGGGGGT",
    "TPPPPPPPPPPPPPPPPPPPPPPPPPPPPPPPPPPPPPPT",
    "PPPPPPPPPPPPPPPPPPPPPPPPPPPPPPPPPPPPPPPP",
    "TPPPPPPPLLLLPPPPPPPPPPPPLLLLPPPPPPPPPPPT",
    "TGGGGGGGGGGGGGGGGGGGGGGGGGGGGGGGGGGGGGGT",
    "TGGGGGGGGGGGGGGGGGGGGGGGGGGGGGGGGGGGGGGT",
    "TGGGGGGGGGGGGGGGGGGGGGGGGGGGGGGGGGGGGGGT",
    "TGGGGGGGGGGGGGGGGGGGGGGGGGGGGGGGGGGGGGGT",
    "TGGGGGGGGGGGGGGGGGGGGGGGGGGGGGGGGGGGGGGT",
    "TGGGGGGGGGGGGGGGGGGGGGGGGGGGGGGGGGGGGGGT",
    "TTTTTTTTTTTTTTTTTTTTTTTTTTTTTTTTTTTTTTTT",
    "TTTTTTTTTTTTTTTTTTTTTTTTTTTTTTTTTTTTTTTT"
  ],
  "warps": [
    {
      "x": 0,
      "y": 8,
      "targetMap": "KANTO_OVERWORLD",
      "targetPos": {
        "x": 39,
        "y": 26
      },
      "targetDir": "left"
    },
    {
      "x": 30,
      "y": 0,
      "targetMap": "MT_MOON",
      "targetPos": {
        "x": 10,
        "y": 19
      },
      "targetDir": "up"
    }
  ]
}