{
  "rows": [
    "TTTTTTTTTTTTTTTTTTTT",
    "TPPPPPPPPPPPPPPPPPPT",
    "TPPPPPPPPPPPPPPPPPPT",
    "TPPPPPPPPPPPPPPPPPPT",
    "GPPPPPPPPPPPPPPPPPPG",
    "TPPPPPPPPPPPPPPPPPPT",
    "TPPPPPPPPPPPPPPPPPPT",
    "TPPPPPPPPPPPPPPPPPPT",
    "TTTTTTTTTTTTTTTTTTTT"
  ],
  "warps": []
}
