{
  "rows": [
    "TTTTTTTTTTTTTTTTTTTTTTTTTTTTTT",
    "TPPPPPPPPPPPPPPPPPPPPPPPPPPPPT",
    "TPPPPPGGGGGGGGGGGGGGGGGGPPPPPT",
    "TPPPPPGGGGGGGGGGGGGGGGGGPPPPPT",
    "GPPPPPGGGGGGGGGGGGGGGGGGPPPPPG",
    "TPPPPPGGGGGGGGGGGGGGGGGGPPPPPT",
    "TPPPPPGGGGGGGGGGGGGGGGGGPPPPPT",
    "TPPPPPPPPPPPPPPPPPPPPPPPPPPPPT",
    "TTTTTTTTTTTTTTTTTTTTTTTTTTTTTT"
  ],
  "warps": []
}
