{
  "rows": [
    "WWWWWWWWWWWWWWWWWWWW",
    "WFFFFFFFFFFFFFFFFFFW",
    "WFFFFFFFFFFFFFFFFFFW",
    "WFFFFFXXFFFFXXFFFFFW",
    "WFFFFFXXFFFFXXFFFFFW",
    "WFFFFFFFFFFFFFFFFFFW",
    "WFFFFFFFFFFFFFFFFFFW",
    "WFFFFFXXFFFFXXFFFFFW",
    "WFFFFFXXFFFFXXFFFFFW",
    "WFFFFFFFFFFFFFFFFFFW",
    "WFFFFFFFFFFFFFFFFFFW",
    "WFFFFFXXFFFFXXFFFFFW",
    "WFFFFFXXFFFFXXFFFFFW",
    "WFFFFFFFFFFFFFFFFFFW",
    "WFFFFFFFFFFFFFFFFFFW",
    "WFFFFFCCCCCCCCFFFFFW",
    "WFFFFFCCCCCCCCFFFFFW",
    "WFFFFFFFFFFFFFFFFFFW",
    "WFFFFFFFFFFFFFFFFFFW",
    "WWWWWWWWWWWWWWWWWWWW"
  ],
  "warps": [
    { "x": 1, "y": 17, "targetMap": "SS_ANNE_2F", "targetPos": { "x": 1, "y": 1 }, "targetDir": "down" }
  ]
}
