{
  "rows": [
    "PPPPPPPPPPPPPPPGPPPPPPPPPPPPPP",
    "PPPPPPPPPPPPPPPPPPPPPPPPPPPPPP",
    "PPPPPPPPPPPPPPPPPPPPPPPPPPPPPP",
    "PPPPPPPPPPPPPPPPPPPPPPPPPPPPPP",
    "PPPPPPPPPPPPPPPPPPPPPPPPPPPPPP",
    "PPPPPPPPPPPPPPPPPPPPPPPPPPPPPP",
    "PPPPPPPPPPPPPPPPPPPPPPPPPPPPPP",
    "PPPPPPPPPPPPPPPPPPPPPPPPPPPPPP",
    "PPPPPPPPPPPPPPPPPPPPPPPPPPPPPP",
    "PPPPPPPPPPPPPPPPPPPPPPPPPPPPPP",
    "PPPPPPPPWWWWPPPPPPWWWWPPPPPPPP",
    "PPPPPPPPWWWWPPPPPPWWWWPPPPPPPP",
    "PPPPPPPPWWWWPPPPPPWWWWPPPPPPPP",
    "PPPPPPPPWWWWPPPPPPWWWWPPPPPPPP",
    "PPPPPPPPPDPPPPPPPPPPDPPPPPPPPP",
    "PPPPPPPPPPPPPPPPPPPPPPPPPPPPPP",
    "PPPPPPPPPPPPPPPPPPPPPPPPPPPPPP",
    "PPPPPPPPPPPPPPPPPPPPPPPPPPPPPP",
    "PPPPPPPPPPPPPPPPPPPPPPPPPPPPPP",
    "PPPPPPPPPPPPPPPPPPPPPPPPPPPPPP",
    "PPPPPPPPPPPPPPPPPPPPPPPPPPPPPP",
    "PPPPPPPPPPPPPPPPPPPPPPPPPPPPPP",
    "PPPPPPPPPPPPPPPPPPPPPPPPPPPPPP",
    "PPPPPPPPPPPPPPPPPPPPPPPPPPPPPP",
    "PPPPPPPPPPPPPPPPPPPPPPPPPPPPPP",
    "PPPPPPPPPPPPPPPPPPPPPPPPPPPPPP",
    "PPPPPPPPPPPPPPPGPPPPPPPPPPPPPP"
  ],
  "warps": [
    { "x": 15, "y": 0,  "targetMap": "VIRIDIAN_FOREST", "targetPos": { "x": 11, "y": 35 }, "targetDir": "up" },
    { "x": 15, "y": 26, "targetMap": "ROUTE_1",         "targetPos": { "x": 4,  "y": 0  }, "targetDir": "down" },
    { "x": 9,  "y": 14, "targetMap": "POKECENTER",      "targetPos": { "x": 6,  "y": 7  }, "targetDir": "up" },
    { "x": 20, "y": 14, "targetMap": "POKEMART",        "targetPos": { "x": 3,  "y": 7  }, "targetDir": "up" }
  ]
}
