{
  "rows": [
    "TTTTTTTTTTTTTTTTTTTTGTTTTTTTTTTTTTTTTTTT",
    "TPPPPPPPPPPPPPPPPPPPPPPPPPPPPPPPPPPPPPPT",
    "TPPPPPPPPPPPPPPPPPPPPPPPPPPPPPPPPPPPPPPT",
    "TPPPPPPPPPPPPPPPPPPPPPPPPPPPPPPPPPPPPPPT",
    "TPPPPPPPPPPPPPPPPPPPPPPPPPPPPPPPPPPPPPPT",
    "TPPPPPPPPPPPPPPPPPPPPPPPPPPPPPPPPPPPPPPT",
    "TPPPPPPPPPPPPPPPPPPPPPPPPPPPPPPPPPPPPPPT",
    "TPPPPPPPPPPPPPPPPPPPPPPPPPPPPPPPPPPPPPPT",
    "TPPPPPPPPPPPPPPPPPPPPPPPPPPPPPPPPPPPPPPT",
    "TPPPPPPPPPPPPPPPPPPPPPPPPPPPPPPPPPPPPPPT",
    "TPPPPPPPPPPPPPPPPPPPPPPPPPPPPPPPPPPPPPPT",
    "TPPPPPPPPPPPPPPPPPPPPPPPPPPPPPPPPPPPPPPT",
    "TPPPPPPPPPPPPPPPPPPPPPPPPPPPPPPPPPPPPPPT",
    "TPPPPPPPPPPPPPPPPPPPPPPPPPPPPPPPPPPPPPPT",
    "TPPPPPPPPPPPPPPPPPPPPPPPPPPPPPPPPPPPPPPT",
    "TPPPPPPPPPPPPWWWWPPPPPPWWWWPPPPPPPPPPPPT",
    "TPPPPPPPPPPPPWWWWPPPPPPWWWWPPPPPPPPPPPPT",
    "TPPPPPPPPPPPPWWWWPPPPPPWWWWPPPPPPPPPPPPT",
    "TPPPPPPPPPPPPWWWWPPPPPPWWWWPPPPPPPPPPPPT",
    "TPPPPPPPPPPPPPDPPPPPPPPPPDPPPPPPPPPPPPPT",
    "TPPPPSPPPPPPPPPPPPPPPPPPPPPPPPPSPPPPPPPT",
    "TPPPPPPPPPPPPPPPPPPPPPPPPPPPPPPPPPPPPPPT",
    "TPPPPPPPPPPPPLLLLPPPPPPPPPPPPPPPPPPPPPPT",
    "TPPPPPPPPPPPPPPPPPPPPPPPPPPPPPPPPPPPPPPT",
    "TPPPPPPPPPPPPP~~~~~~PPPPPPPPPPPPPPPPPPPT",
    "TPPPPPPPPPPPPP~~~~~~PPPPPPWWWWWPPPPPPPPT",
    "TPPPPPPPPPPPPP~~~~~~PPPPPPWWWWWPPPPPPPPT",
    "TPPPPPPPPPPPPP~~~~~~PPPPPPWWWWWPPPPPPPPT",
    "TPPPPPPPPPPPPPPPPPPPPPPPPPWWDWWPPPPPPPPT",
    "TPPPPPPPPPPPPPPPPPPPPPPPPPPPPPPPPPPPPPPT",
    "TPPPPPPPPPPPPPPPPPPPPPPPPPPSPPPPPPPPPPPT",
    "TPPPPPPPPPPPPPPPPPPPPPPPPPPPPPPPPPPPPPPT",
    "TPPPPPPPPPPPPPPPPPPPPPPPPPPPPPPPPPPPPPPT",
    "TPPPPPPPPPPPPPPPPPPPPPPPPPPPPPPPPPPPPPPT",
    "TPPPPPPPPPPPPPPPPPPPPPPPPPPPPPPPPPPPPPPT",
    "TTTTTTTTTTTTTTTTTTTTGTTTTTTTTTTTTTTTTTTT"
  ],
  "warps": [
    {
      "x": 20,
      "y": 0,
      "targetMap": "KANTO_OVERWORLD",
      "targetPos": {
        "x": 20,
        "y": 128
      },
      "targetDir": "up"
    },
    {
      "x": 20,
      "y": 35,
      "targetMap": "KANTO_OVERWORLD",
      "targetPos": {
        "x": 20,
        "y": 163
      },
      "targetDir": "down"
    },
    {
      "x": 14,
      "y": 19,
      "targetMap": "POKECENTER",
      "targetPos": {
        "x": 6,
        "y": 7
      },
      "targetDir": "up"
    },
    {
      "x": 25,
      "y": 19,
      "targetMap": "POKEMART",
      "targetPos": {
        "x": 3,
        "y": 7
      },
      "targetDir": "up"
    }
  ]
}