{
  "rows": [
    "PPPPPPPPPPPPPPPPPPPP",
    "PPPPPPPPPPPPPPPPPPPP",
    "PPPPPPPPPPPPPPPPPPPP",
    "PPPPPPPPPPPPPPPPPPPP",
    "PPPPPPPPPPPPPPPPPPPP",
    "PPPPPWWWWPPPWWWWPPPP",
    "PPPPPWWWWPPPWWWWPPPP",
    "PPPPPWWWWPPPWWWWPPPP",
    "PPPPPWWDWPPPWWDWPPPP",
    "PPPPPPPPPPPPPPPPPPPP",
    "PPPPPPPPPPPPPPPPPPPP",
    "PPPPPPPPPPPPPPPPPPPP",
    "PPPPPPPPPPPPPPPPPPPP",
    "PPPPPPPPPPPPPPPPPPPP",
    "PPPPPPPPPPPPPPPPPPPP",
    "PPPPPPPPPPPPPPPPPPPP",
    "PPPPPPPPPPPPPPPPPPPP",
    "PPPPPPPPPPPPPPPPPPPP",
    "PPPPPPPPPPPPPPPPPPPP",
    "PPPPPPPPPPPPPPPPPPPP"
  ]
}
