{
  "rows": [
    "TTTTTTTTTTTTTTTTTTTT",
    "TTTTTTTTTTTTTTTTTTTT",
    "TTTGGGGGGGGGGGGGGTTT",
    "TTTGGGGGGGGGGGGGGTTT",
    "TTTGGGGGGGGGGGGGGTTT",
    "TTTGGGGGGGGGGGGGGTTT",
    "TTTGGGGGGGGGGGGGGTTT",
    "TTTGGGGGTGGGGGGGGTTT",
    "TTTGGGGGGGGGGGGGGTTT",
    "TTTGGGTGGGGTGGGGGTTT",
    "TTTGGGGGGGTGGGGGGTTT",
    "TTTGGGGGGGGGGGGGGTTT",
    "TTTGGGGGGGGGGGGGGTTT",
    "TTTGGGGGGTGGGGGGGTTT",
    "TTTGGGGGGGGGGGGGGTTT",
    "TTTGGGGGGGGGGGGGGTTT",
    "TTTGGGGGGGGGGGGGGTTT",
    "TTTGGGGGGGGGGGGGGTTT",
    "TTTTTTTTTTTTTTTTTTTT",
    "TTTTTTTTTTTTTTTTTTTT"
  ]
}
