{
  "rows": [
    "TTTTTTTTTTPTTTTTTTTT",
    "TTTTTTTTTTPTTTTTTTTT",
    "TTTGGGGGGGGGGGGGGTTT",
    "TTTGGGGGGGGGGGGGGTTT",
    "TTTGGGGGGGGGGGGGGTTT",
    "TTTGGGGGGGGGGGGGGTTT",
    "TTTGGGGGGGGGGGGGGTTT",
    "TTTGGGGGTGGGGGGGGTTT",
    "TTTGGGGGGGGGGGGGGTTT",
    "TTTGGGTGGGGTGGGGGTTT",
    "TTTGGGGGGGTGGGGGGTTT",
    "TTTGGGGGGGGGGGGGGTTT",
    "TTTGGGGGGGGGGGGGGTTT",
    "TTTGGGGGGTGGGGGGGTTT",
    "TTTGGGGGGGGGGGGGGTTT",
    "TTTGGGGGGGGGGGGGGTTT",
    "TTTGGGGGGGGGGGGGGTTT",
    "TTTGGGGGGGGGGGGGGTTT",
    "TTTTTTTTTTPTTTTTTTTT",
    "TTTTTTTTTTPTTTTTTTTT"
  ],
  "warps": [
    { "x": 10, "y": 19, "targetMap": "VIRIDIAN_CITY", "targetPos": { "x": 10, "y": 1 }, "targetDir": "down" },
    { "x": 10, "y": 0, "targetMap": "PEWTER_CITY", "targetPos": { "x": 10, "y": 16 }, "targetDir": "up" }
  ]
}