{
  "rows": [
    "TTTTTTTTTTTGTTTTTTTTTTTT",
    "TGGGGGGGGGGGGGGGGGGGGGGT",
    "TGGGGGGGGGGGGGGGGGGGGGGT",
    "TGGGGGGGGGGGGGGGGGGGGGGT",
    "TGGGGGGGGGGGGGGGGGGGGGGT",
    "TGGGGGGGGGGGGGGGGGGGGGGT",
    "TGGGGGGGGGGGGGGGGGGGGGGT",
    "TGGGGGGGTGGGGGGGGGGGGGGT",
    "TGGGGGGGGGGGGGGGGGGGGGGT",
    "TGGGGTGGGGGTGGGGGGGGGGGT",
    "TGGGGGGGGGTGGGGGGGGGGGGT",
    "TGGGGGGGGGGGGGGGGGGGGGGT",
    "TGGGGGGGGGGGGGGGGGGGGGGT",
    "TGGGGGGGGGGGGGGGGGGGGGGT",
    "TGGGGGGGGGGGGGGGGGGGGGGT",
    "TGGGGGGGGGGGGGGGGGGGGGGT",
    "TGGGGGGGGGGGGGGGGGGGGGGT",
    "TGGGGGGGGGGGGGGGGGGGGGGT",
    "TGGGGGGGGGGGGGGGGGGGGGGT",
    "TGGGGGGGGGGGGGGGGGGGGGGT",
    "TGGGGGGGGGGGGGGGGGGGGGGT",
    "TGGGGGGGGGGGGGGGGGGGGGGT",
    "TGGGGGGGGGGGGGGGGGGGGGGT",
    "TGGGGGGGGGGGGGGGGGGGGGGT",
    "TGGGGGGGGGGGGGGGGGGGGGGT",
    "TGGGGGGGGGGGGGGGGGGGGGGT",
    "TGGGGGGGGGGGGGGGGGGGGGGT",
    "TGGGGGGGGGGGGGGGGGGGGGGT",
    "TGGGGGGGGGGGGGGGGGGGGGGT",
    "TGGGGGGGGGGGGGGGGGGGGGGT",
    "TGGGGGGGGGGGGGGGGGGGGGGT",
    "TGGGGGGGGGGGGGGGGGGGGGGT",
    "TGGGGGGGGGGGGGGGGGGGGGGT",
    "TGGGGGGGGGGGGGGGGGGGGGGT",
    "TGGGGGGGGGGGGGGGGGGGGGGT",
    "TTTTTTTTTTTGTTTTTTTTTTTT"
  ],
  "warps": [
    { "x": 11, "y": 0,  "targetMap": "PEWTER_CITY",   "targetPos": { "x": 15, "y": 26 }, "targetDir": "up" },
    { "x": 11, "y": 35, "targetMap": "ROUTE_2",       "targetPos": { "x": 4,  "y": 0  }, "targetDir": "down" }
  ]
}
