{
  "rows": [
    "TTTTTTTTTTTTTTTTTTTTPPTTTTTTTTTTTTTTTTTT",
    "TTTTTTTTTTTTTTTTTTTTPPTTTTTTTTTTTTTTTTTT",
    "TTTTTTTTTTTTTTTTTTTTPPTTTTTTTTTTTTTTTTTT",
    "TTTTTTTTTTTTTTTTTTTTPPTTTTTTTTTTTTTTTTTT",
    "TTTTTTTTTTTTTTTTTTTTPPTTTTTTTTTTTTTTTTTT",
    "TTTTT+++++++++++++++PP+++++++++++++TTTTT",
    "TTTTTPPPPPPPPPPPPPPPPPPPPPPPPPPPPPPTTTTT",
    "TTTTTPPPPPPPPPPPPPPPPPPPPWWWWWWWPPPTTTTT",
    "TTTTTPPPPPPPPPPPPPPPPPPPPWWWWWWWPPPTTTTT",
    "TTTTTPPPPPPPPPPPPPPPPPPPPWWWWWWWPPPTTTTT",
    "TTTTTPPPPPPPPPPPPPPPPPPPPWWWWWWWPPPTTTTT",
    "TTTTTPPPPPPPPPPPPPPPPPPPPWWWDWWWPPPTTTTT",
    "TTTTTPPPPPPPWWWWWWPPPPPPPPPPPPPPPPPTTTTT",
    "TTTTTPPPPPPPWWWWWWPPPPPPPPPPPPPPPPPTTTTT",
    "TTTTTPPPPPPPWWWWWWPPPPPPPPPPPPPPPPPTTTTT",
    "PPPPPPPPPPPPWWDWWWPPPPPPPPPPPPPPPPPTTTTT",
    "PPPPPPPPPPPPPPPPPPPPPPPPPPPPPPPPPPPTTTTT",
    "TTTTTPPPPPPPPPPPPPPPPPPPPPPPPPPPPPPTTTTT",
    "TTTTTPPPPPPPPPPPPPPPPPPPWWWWWPPPPPPTTTTT",
    "TTTTTPPPPPPPPPPPPPPPPPPPWWWWWPPPPPPTTTTT",
    "TTTTTPPLLLLPPPPPPPPPPPPPWWWWWPPPPPPTTTTT",
    "TTTTTPPPPPPPPPPPPPPPPPPPWDSWWPPPPPPTTTTT",
    "TTTTTPPPPPPPPPPPPPPPPPPPPPPPPPPPPPPTTTTT",
    "TTTTTPPPPPPPPPPPPPPPPPPPPPPPPPPPPPPTTTTT",
    "TTTTTPPPPPPPPPPPPPPPPPPPPPPPPPPPPPPTTTTT",
    "TTTTTPPPPPWWWWWPPPPPPPPPPPPPPPPPPPPTTTTT",
    "TTTTTPPPPPWWWWWPPP~~~~PPPPPPPPPPPPPTTTTT",
    "TTTTTPPPPPWWWWWPPP~~~~PPPPPPPPPPPPPTTTTT",
    "TTTTTPPPPPWDSWWPPP~~~~PPPGGGGGGPPPPTTTTT",
    "TTTTTPPPPPPPPPPPPP~~~~PPPGGGGGGPPPPTTTTT",
    "TTTTTPPPPPPPPPPPPPPPPPPPPGGGGGGPPPPTTTTT",
    "TTTTTPPPPPPPPPPPPPPPPPPPPGGGGGGPPPPTTTTT",
    "TTTTTPPPPPPPPPPPPPPPPPPPPPPPPPPPPPPTTTTT",
    "TTTTTTTTTTTTTTTTTTTTPPTTTTTTTTTTTTTTTTTT",
    "TTTTTTTTTTTTTTTTTTTTPPTTTTTTTTTTTTTTTTTT",
    "TTTTTTTTTTTTTTTTTTTTPPTTTTTTTTTTTTTTTTTT"
  ],
  "warps": [
    {
      "x": 20,
      "y": 0,
      "targetMap": "KANTO_OVERWORLD",
      "targetPos": {
        "x": 20,
        "y": 128
      },
      "targetDir": "up"
    },
    {
      "x": 21,
      "y": 0,
      "targetMap": "KANTO_OVERWORLD",
      "targetPos": {
        "x": 21,
        "y": 128
      },
      "targetDir": "up"
    },
    {
      "x": 20,
      "y": 35,
      "targetMap": "KANTO_OVERWORLD",
      "targetPos": {
        "x": 20,
        "y": 163
      },
      "targetDir": "down"
    },
    {
      "x": 21,
      "y": 35,
      "targetMap": "KANTO_OVERWORLD",
      "targetPos": {
        "x": 21,
        "y": 163
      },
      "targetDir": "down"
    },
    {
      "x": 11,
      "y": 28,
      "targetMap": "POKECENTER",
      "targetPos": {
        "x": 6,
        "y": 7
      },
      "targetDir": "up"
    },
    {
      "x": 25,
      "y": 21,
      "targetMap": "POKEMART",
      "targetPos": {
        "x": 3,
        "y": 7
      },
      "targetDir": "up"
    }
  ]
}