{
  "rows": [
    "TTTTTTTTTTTTTTTTTTTTGTTTTTTTTTTTTTTTTTTT",
    "TPPPPPPPPPPPPPPPPPPPPPPPPPPPPPPPPPPPPPPT",
    "TPPPPPPPPPPPPPPPPPPPPPPPPPPPPPPPPPPPPPPT",
    "TPPPPPPPPPPPPPPPPPPPPPPPPPPPPPPPPPPPPPPT",
    "TPPPPPPPPPPPPPPPPPPPPPPPPPPPPPPPPPPPPPPT",
    "TPPPPPPPPPPPPPPPPPPPPPPPPPPPPPPPPPPPPPPT",
    "TPPPPPPPPPPPPPPPPPPPPPPPPPPPPPPPPPPPPPPT",
    "TPPPPPPPPPPPPPPPPPPPPPPPPPPPPPPPPPPPPPPT",
    "TPPPPPPPPPPPPPPPPPPPPPPPPPPPPPPPPPPPPPPT",
    "TPPPPPPPPPPPPPPPPPPPPPPPPPPPPPPPPPPPPPPT",
    "TPPPPPPPPPPPPPPPPPPPPPPPPPPPPPPPPPPPPPPT",
    "TPPPPPPPPPPPPPPPPPPPPPPPPPPPPPPPPPPPPPPT",
    "TPPPPPPPPPPPPPPPPPPPPPPPPPPPPPPPPPPPPPPT",
    "TPPPPPPPPPPPPPPPPPPPPPPPPPPPPPPPPPPPPPPT",
    "TPPPPPPPPPPPPPPPPPPPPPPPPPPPPPPPPPPPPPPT",
    "TPPPPPPPPPPPPWWWWPPPPPPWWWWPPPPPPPPPPPPT",
    "TPPPPPPPPPPPPWWWWPPPPPPWWWWPPPPPPPPPPPPT",
    "TPPPPPPPPPPPPWWWWPPPPPPWWWWPPPPPPPPPPPPT",
    "TPPPPPPPPPPPPWWWWPPPPPPWWWWPPPPPPPPPPPPT",
    "TPPPPPPPPPPPPPDPPPPPPPPPPDPPPPPPPPPPPPPT",
    "TPPPPPPPPPPPPPPPPPPPPPPPPPPPPPPPPPPPPPPPT",
    "TPPPPPPPPPPPPPPPPPPPPPPPPPPPPPPPPPPPPPPT",
    "TPPPPPPPPPPPPLLLLPPPPPPPPPPPPPPPPPPPPPPT",
    "TPPPPPPPPPPPPPPPPPPPPPPPPPPPPPPPPPPPPPPT",
    "TPPPPPPPPPPPPP~~~~~~PPPPPPPPPPPPPPPPPPPT",
    "TPPPPPPPPPPPPP~~~~~~PPPPPPWWWWWPPPPPPPPT",
    "TPPPPPPPPPPPPP~~~~~~PPPPPPWWWWWPPPPPPPPT",
    "TPPPPPPPPPPPPP~~~~~~PPPPPPWWWWWPPPPPPPPT",
    "TPPPPPPPPPPPPPPPPPPPPPPPPPWWDWWPPPPPPPPT",
    "TPPPPPPPPPPPPPPPPPPPPPPPPPPPPPPPPPPPPPPT",
    "TPPPPPPPPPPPPPPPPPPPPPPPPPPPPPPPPPPPPPPPT",
    "TPPPPPPPPPPPPPPPPPPPPPPPPPPPPPPPPPPPPPPT",
    "TPPPPPPPPPPPPPPPPPPPPPPPPPPPPPPPPPPPPPPT",
    "TPPPPPPPPPPPPPPPPPPPPPPPPPPPPPPPPPPPPPPT",
    "TPPPPPPPPPPPPPPPPPPPPPPPPPPPPPPPPPPPPPPT",
    "TTTTTTTTTTTTTTTTTTTTGTTTTTTTTTTTTTTTTTTT"
  ],
  "warps": [
    { "x": 20, "y": 0,  "targetMap": "ROUTE_2",    "targetPos": { "x": 4,  "y": 39 }, "targetDir": "up" },
    { "x": 20, "y": 35, "targetMap": "ROUTE_1",    "targetPos": { "x": 4,  "y": 0  }, "targetDir": "down" },
    { "x": 14, "y": 19, "targetMap": "POKECENTER", "targetPos": { "x": 6,  "y": 6  }, "targetDir": "up" },
    { "x": 25, "y": 19, "targetMap": "POKEMART",   "targetPos": { "x": 3,  "y": 6  }, "targetDir": "up" },
    { "x": 28, "y": 28, "targetMap": "POKECENTER", "targetPos": { "x": 6,  "y": 6  }, "targetDir": "up" }
  ]
}
