{
  "rows": [
    "TTTTTTTTTTTTTTTTGTTTTTTTTTTTTTTTTT",
    "TGGGGGGGGGGGGGGGGGGGGGGGGGGGGGGGGT",
    "TGGGGGGGGGGGGGGGGGGGGGGGGGGGGGGGGT",
    "TGGGGGGGGGGGGGGGGGGGGGGGGGGGGGGGGT",
    "TGGGGGGGGGGGGGGGGGGGGGGGGGGGGGGGGT",
    "TGGGGGGGGGGGGGGGGGGGGGGGGGGGGGGGGT",
    "TGGGGGGGGGGGGGGGGGGGGGGGGGGGGGGGGT",
    "TGGGGGGGGGGGGGGGGGGGGGGGGGGGGGGGGT",
    "TGGGGGGGGGGGGGGGGGGGGGGGGGGGGGGGGT",
    "TGGGGGGGGGGGGGGGGGGGGGGGGGGGGGGGGT",
    "TTTTTTTTTGGGTTTTTTTTTTTTTTTTTTTTTT",
    "TGGGGGGGGGGGGGGGGGGGGGGGGGGGGGGGGT",
    "TGGGGGGGGGGGGGGGGGGGGGGGGGGGGGGGGT",
    "TGGGGGGGGGGGGGGGGGGGGGGGGGGGGGGGGT",
    "TGGGGGGGGGGGGGGGGGGGGGGGGGGGGGGGGT",
    "TGGGGGGGGGGGGGGGGGGGGGGGGGGGGGGGGT",
    "TGGGGGGGGGGGGGGGGGGGGGGGGGGGGGGGGT",
    "TGGGGGGGGGGGGGGGGGGGGGGGGGGGGGGGGT",
    "TGGGGGGGGGGGGGGGGGGGGGGGGGGGGGGGGT",
    "TGGGGGGGGGGGGGGGGGGGGGGGGGGGGGGGGT",
    "TTTTTTTTTTTGGGTTTTTTTTTTTTTTTTTTTT",
    "TGGGGGGGGGGGGGGGGGGGGGGGGGGGGGGGGT",
    "TGGGGGGGGGGGGGGGGGGGGGGGGGGGGGGGGT",
    "TGGGGGGGGGGGGGGGGGGGGGGGGGGGGGGGGT",
    "TGGGGGGGGGGGGGGGGGGGGGGGGGGGGGGGGT",
    "TGGGGGGGGGGGGGGGGGGGGGGGGGGGGGGGGT",
    "TGGGGGGGGGGGGGGGGGGGGGGGGGGGGGGGGT",
    "TGGGGGGGGGGGGGGGGGGGGGGGGGGGGGGGGT",
    "TTTTTTTTTTTTTTTTTTGGGTTTTTTTTTTTTT",
    "TGGGGGGGGGGGGGGGGGGGGGGGGGGGGGGGGT",
    "TGGGGGGGGGGGGGGGGGGGGGGGGGGGGGGGGT",
    "TGGGGGGGGGGGGGGGGGGGGGGGGGGGGGGGGT",
    "TGGGGGGGGGGGGGGGGGGGGGGGGGGGGGGGGT",
    "TGGGGGGGGGGGGGGGGGGGGGGGGGGGGGGGGT",
    "TGGGGGGGGGGGGGGGGGGGGGGGGGGGGGGGGT",
    "TGGGGGGGGGGGGGGGGGGGGGGGGGGGGGGGGT",
    "TGGGGGGGGGGGGGGGGGGGGGGGGGGGGGGGGT",
    "TGGGGGGGGGGGGGGGGGGGGGGGGGGGGGGGGT",
    "TTTTTTTTTTTTTTTTTTTTTTTTTGGGTTTTTT",
    "TGGGGGGGGGGGGGGGGGGGGGGGGGGGGGGGGT",
    "TGGGGGGGGGGGGGGGGGGGGGGGGGGGGGGGGT",
    "TGGGGGGGGGGGGGGGGGGGGGGGGGGGGGGGGT",
    "TGGGGGGGGGGGGGGGGGGGGGGGGGGGGGGGGT",
    "TGGGGGGGGGGGGGGGGGGGGGGGGGGGGGGGGT",
    "TGGGGGGGGGGGGGGGGGGGGGGGGGGGGGGGGT",
    "TGGGGGGGGGGGGGGGGGGGGGGGGGGGGGGGGT",
    "TGGGGGGGGGGGGGGGGGGGGGGGGGGGGGGGGT",
    "TTTTTTTTTTTTTTTTGTTTTTTTTTTTTTTTTT"
  ],
  "warps": [
    {
      "x": 16,
      "y": 0,
      "targetMap": "KANTO_OVERWORLD",
      "targetPos": {
        "x": 20,
        "y": 42
      },
      "targetDir": "up"
    },
    {
      "x": 16,
      "y": 47,
      "targetMap": "KANTO_OVERWORLD",
      "targetPos": {
        "x": 20,
        "y": 89
      },
      "targetDir": "down"
    }
  ]
}